##########################################
#                                        ################
#                                                       #
#################################################  ######
                                                #  #
                                                #  #
                                                #  #
                                                #  #
#################################################  #
                                                   #
                                                   #
####################################################