##########################################
#  @                                     ################
#                                                       #
#################################################   ######
                                                #   #
                                                #   #
                                                #   #
                                                #   #
#################################################   #
E                                                   #
                                                    #
#####################################################